##########
#    T   #
#       #
#   D    #
#   E    #
#*       #
#P     * #
##########
