##########
#    T   #
#        #
#   D    #
#   E    #
#*       #
#P     * #
##########
