##########
# E  EEE T   #
#E       #
# E E D    #
#   E    #
#* E      #
#P E   E * #
##########
